From	To
BM CD34+ Cells	BM_CD34
Whole Blood	Whole blood
Blood	Whole blood
WB	Whole blood
BM CD34+ Cells	BM_CD34
Bcells	B cells
B Cells	B cells
NK Cells	NK cells
NKcells	NK cells
T-Cells	T cells
Tâˆ’Cells	T cells
Tcells	T cells
BM_Bcells	BM B cells
BM T Cells	BM T cells
BM_Monocytes	BM Monocytes
BM_NKcells	BM NK cells
BM_Tcells	BM T cells
NK Cells	NK cells
NKcells	NK cells
